home,score,Visit,years,fifa
,,,1930,FIFA
,,,1934,FIFA
,,,1938,FIFA
,,,1950,FIFA
,,,1958,FIFA
,,,1962,FIFA
,,,1966,FIFA
,,,1970,FIFA
,,,1974,FIFA
,,,1978,FIFA
,,,1982,FIFA
,,,1986,FIFA
,,,1990,FIFA
,,,1994,FIFA
,,,1998,FIFA
,,,2002,FIFA
,,,2006,FIFA
,,,2010,FIFA
,,,2014,FIFA
,,,2018,FIFA
